# Syntax Coloring Map for LoRaMesh

# Datatypes (KEYWORD1)
LoRaMesh	KEYWORD1
RoutingEntry	KEYWORD1
MeshHeader	KEYWORD1
MessageType	KEYWORD1
RouteState	KEYWORD1

# Methods and Functions (KEYWORD2)
begin	KEYWORD2
setAddress	KEYWORD2
getAddress	KEYWORD2
setSPI	KEYWORD2
setPins	KEYWORD2
setSPIFrequency	KEYWORD2
sendToWait	KEYWORD2
recvFromAck	KEYWORD2
available	KEYWORD2
process	KEYWORD2
getRoutingTable	KEYWORD2
getRoutingTableSize	KEYWORD2
printRoutingTable	KEYWORD2
setRetries	KEYWORD2
setRetryTimeout	KEYWORD2

# Constants (LITERAL1)
LORAMESH_MAX_MESSAGE_LEN	LITERAL1
LORAMESH_ROUTING_TABLE_SIZE	LITERAL1
LORAMESH_MAX_HOPS	LITERAL1
LORAMESH_ROUTE_TIMEOUT	LITERAL1
LORAMESH_ROUTE_DISCOVERY_TIMEOUT	LITERAL1
LORAMESH_BROADCAST_ADDRESS	LITERAL1
MESSAGE_TYPE_DATA	LITERAL1
MESSAGE_TYPE_ROUTE_REQUEST	LITERAL1
MESSAGE_TYPE_ROUTE_REPLY	LITERAL1
MESSAGE_TYPE_ROUTE_FAILURE	LITERAL1
ROUTE_STATE_INVALID	LITERAL1
ROUTE_STATE_DISCOVERING	LITERAL1
ROUTE_STATE_VALID	LITERAL1